PAYMENT_NUMBER,MONTH,PAYMENT,PRINCIPAL,PERCENT_PRINCIPAL_OF_PAYMENT,INTEREST,PERCENT_INTEREST_OF_PAYMENT,REMAINING_BALANCE,PERCENT_OF_LOAN_PAID,PERCENT_OF_ASSET_OWNED
1,1,516.22,69.55,13.472937894696058,446.67,86.52706210530394,79930.45,0.08693750000000477,20.069550000000007
2,2,516.22,69.94,13.548487079152299,446.28,86.45151292084769,79860.51,0.17436250000000086,20.13949000000001
3,3,516.22,70.33,13.624036263608538,445.89,86.37596373639145,79790.18,0.2622750000000167,20.209820000000008
4,4,516.22,70.72,13.699585448064777,445.5,86.3004145519352,79719.45999999999,0.3506750000000096,20.280540000000016
5,5,516.22,71.12,13.777071791096821,445.1,86.22292820890318,79648.34,0.43957500000000493,20.35166000000001
6,6,516.22,71.52,13.854558134128858,444.7,86.14544186587113,79576.81999999999,0.5289750000000026,20.423180000000002
7,7,516.22,71.92,13.932044477160899,444.3,86.0679555228391,79504.9,0.6188750000000027,20.495100000000008
8,8,516.22,72.32,14.00953082019294,443.9,85.99046917980705,79432.57999999999,0.7092750000000194,20.567420000000013
9,9,516.22,72.72,14.08701716322498,443.5,85.91298283677502,79359.85999999999,0.8001750000000101,20.640140000000017
10,10,516.22,73.13,14.166440664832821,443.09,85.83355933516717,79286.72999999998,0.8915875000000284,20.713270000000023
11,11,516.22,73.54,14.245864166440667,442.68,85.75413583355933,79213.18999999999,0.9835125000000176,20.786810000000017
12,12,516.22,73.95,14.325287668048507,442.27,85.67471233195148,79139.23999999999,1.0759500000000202,20.860760000000013
13,1,516.22,74.36,14.404711169656348,441.86,85.59528883034365,79064.87999999999,1.168900000000022,20.935120000000012
14,2,516.22,74.77,14.484134671264187,441.45,85.51586532873581,78990.10999999999,1.262362500000009,21.009890000000013
15,3,516.22,75.19,14.565495331447831,441.03,85.43450466855217,78914.91999999998,1.3563500000000204,21.085080000000005
16,4,516.22,75.61,14.646855991631474,440.61,85.35314400836852,78839.30999999998,1.4508625000000137,21.160690000000017
17,5,516.22,76.03,14.728216651815117,440.19,85.27178334818488,78763.27999999998,1.5459000000000174,21.23672000000002
18,6,516.22,76.46,14.811514470574561,439.76,85.18848552942544,78686.81999999998,1.6414750000000282,21.313180000000017
19,7,516.22,76.89,14.894812289334002,439.33,85.10518771066599,78609.92999999998,1.737587500000032,21.390070000000023
20,8,516.22,77.31,14.976172949517647,438.91,85.02382705048235,78532.61999999998,1.8342250000000178,21.46738000000002
21,9,516.22,77.75,15.06140792685289,438.47,84.9385920731471,78454.86999999998,1.931412500000036,21.54513000000003
22,10,516.22,78.18,15.144705745612336,438.04,84.85529425438766,78376.68999999999,2.0291375000000045,21.623310000000004
23,11,516.22,78.62,15.22994072294758,437.6,84.77005927705243,78298.06999999999,2.1274125000000197,21.701930000000004
24,12,516.22,79.06,15.315175700282824,437.16,84.68482429971718,78219.01,2.2262375000000105,21.780990000000003
25,1,516.22,79.5,15.400410677618067,436.72,84.59958932238193,78139.51,2.3256125000000054,21.860490000000013
26,2,516.22,79.94,15.485645654953315,436.28,84.51435434504667,78059.56999999999,2.4255375000000043,21.940430000000006
27,3,516.22,80.39,15.57281779086436,435.83,84.42718220913564,77979.18,2.526025000000004,22.020820000000015
28,4,516.22,80.84,15.659989926775406,435.38,84.34001007322459,77898.34,2.627075000000005,22.101659999999995
29,5,516.22,81.29,15.747162062686451,434.93,84.25283793731354,77817.05,2.7286874999999924,22.182950000000005
30,6,516.22,81.74,15.834334198597496,434.48,84.1656658014025,77735.31,2.830862499999995,22.26469
31,7,516.22,82.2,15.923443493084344,434.02,84.07655650691565,77653.11,2.9336125000000095,22.346890000000002
32,8,516.22,82.66,16.012552787571188,433.56,83.9874472124288,77570.45,3.0369375000000076,22.429549999999992
33,9,516.22,83.12,16.101662082058038,433.1,83.89833791794197,77487.33,3.1408374999999893,22.51267
34,10,516.22,83.58,16.190771376544884,432.64,83.80922862345511,77403.75,3.245312499999997,22.596249999999998
35,11,516.22,84.05,16.28181782960753,432.17,83.71818217039247,77319.7,3.3503749999999997,22.680300000000003
36,12,516.22,84.52,16.37286428267018,431.7,83.62713571732982,77235.18,3.456025000000011,22.764820000000014
37,1,516.22,84.99,16.463910735732824,431.23,83.53608926426718,77150.18999999999,3.562262500000017,22.84981000000002
38,2,516.22,85.46,16.55495718879547,430.76,83.44504281120452,77064.72999999998,3.6690875000000176,22.935270000000017
39,3,516.22,85.94,16.647940800433922,430.28,83.35205919956607,76978.78999999998,3.776512500000024,23.021210000000025
40,4,516.22,86.42,16.74092441207237,429.8,83.25907558792763,76892.36999999998,3.884537500000036,23.10763000000003
41,5,516.22,86.9,16.833908023710823,429.32,83.16609197628917,76805.46999999999,3.993162500000011,23.194530000000015
42,6,516.22,87.39,16.928828793925067,428.83,83.07117120607492,76718.07999999999,4.102400000000017,23.281920000000014
43,7,516.22,87.88,17.02374956413932,428.34,82.97625043586066,76630.19999999998,4.212250000000012,23.369800000000012
44,8,516.22,88.37,17.11867033435357,427.85,82.88132966564643,76541.82999999999,4.322712500000009,23.45817000000001
45,9,516.22,88.86,17.21359110456782,427.36,82.78640889543217,76452.96999999999,4.433787500000022,23.547030000000007
46,10,516.22,89.36,17.31044903335787,426.86,82.68955096664212,76363.60999999999,4.545487500000021,23.63639000000002
47,11,516.22,89.86,17.40730696214792,426.36,82.59269303785207,76273.74999999999,4.65781250000002,23.72625000000002
48,12,516.22,90.36,17.50416489093797,425.86,82.49583510906203,76183.38999999998,4.770762500000018,23.81661000000001
49,1,516.22,90.86,17.601022819728023,425.36,82.39897718027197,76092.52999999998,4.884337500000029,23.907470000000018
50,2,516.22,91.37,17.699817907093877,424.85,82.30018209290613,76001.15999999999,4.998550000000009,23.998840000000015
51,3,516.22,91.88,17.798612994459724,424.34,82.20138700554025,75909.27999999998,5.113400000000027,24.09072000000002
52,4,516.22,92.39,17.897408081825578,423.83,82.10259191817441,75816.88999999998,5.228887500000027,24.183110000000013
53,5,516.22,92.91,17.998140327767228,423.31,82.00185967223277,75723.97999999998,5.345025000000021,24.276020000000017
54,6,516.22,93.43,18.098872573708885,422.79,81.90112742629113,75630.54999999999,5.461812500000022,24.369450000000015
55,7,516.22,93.95,18.199604819650535,422.27,81.80039518034945,75536.59999999999,5.579250000000016,24.463400000000007
56,8,516.22,94.47,18.30033706559219,421.75,81.6996629344078,75442.12999999999,5.697337500000003,24.55787000000001
57,9,516.22,95.0,18.40300647010964,421.22,81.59699352989036,75347.12999999999,5.816087500000009,24.652870000000007
58,10,516.22,95.53,18.505675874627094,420.69,81.4943241253729,75251.59999999999,5.935500000000019,24.748400000000004
59,11,516.22,96.07,18.61028243772035,420.15,81.38971756227964,75155.52999999998,6.055587500000016,24.844470000000015
60,12,516.22,96.6,18.712951842237803,419.62,81.28704815776219,75058.92999999998,6.176337500000031,24.941070000000025
61,1,516.22,97.14,18.81755840533106,419.08,81.18244159466893,74961.78999999998,6.297762500000033,25.03821000000002
62,2,516.22,97.68,18.922164968424315,418.54,81.07783503157569,74864.10999999999,6.419862500000022,25.135890000000018
63,3,516.22,98.23,19.02870869009337,417.99,80.97129130990662,74765.87999999999,6.542650000000023,25.23412000000002
64,4,516.22,98.78,19.135252411762426,417.44,80.86474758823758,74667.09999999999,6.666125000000008,25.33290000000001
65,5,516.22,99.33,19.24179613343148,416.89,80.75820386656851,74567.76999999999,6.790287500000019,25.432230000000004
66,6,516.22,99.88,19.348339855100534,416.34,80.65166014489945,74467.88999999998,6.915137500000029,25.532110000000017
67,7,516.22,100.44,19.456820735345392,415.78,80.5431792646546,74367.44999999998,7.040687500000018,25.632550000000023
68,8,516.22,101.0,19.56530161559025,415.22,80.43469838440976,74266.44999999998,7.1669375000000315,25.733550000000022
69,9,516.22,101.57,19.67571965441091,414.65,80.32428034558909,74164.87999999998,7.293900000000036,25.835120000000018
70,10,516.22,102.13,19.784200534655767,414.09,80.21579946534423,74062.74999999997,7.421562500000036,25.937250000000034
71,11,516.22,102.7,19.894618573476425,413.52,80.10538142652356,73960.04999999997,7.549937500000041,26.03995000000002
72,12,516.22,103.28,20.006973770872882,412.94,79.99302622912711,73856.76999999997,7.679037500000035,26.14323000000003
73,1,516.22,103.85,20.117391809693537,412.37,79.88260819030646,73752.91999999997,7.808850000000035,26.24708000000004
74,2,516.22,104.43,20.22974700709,411.79,79.77025299291,73648.48999999998,7.939387500000024,26.35151000000002
75,3,516.22,105.02,20.344039363062258,411.2,79.65596063693773,73543.46999999997,8.07066250000004,26.45653000000003
76,4,516.22,105.6,20.45639456045872,410.62,79.54360543954128,73437.86999999997,8.202662500000045,26.562130000000025
77,5,516.22,106.19,20.570686916430976,410.03,79.42931308356901,73331.67999999996,8.33540000000005,26.668320000000037
78,6,516.22,106.78,20.68497927240324,409.44,79.31502072759675,73224.89999999997,8.46887500000004,26.775100000000023
79,7,516.22,107.38,20.801208786951296,408.84,79.1987912130487,73117.51999999996,8.603100000000055,26.882480000000044
80,8,516.22,107.98,20.91743830149936,408.24,79.08256169850064,73009.53999999996,8.738075000000052,26.99046000000004
81,9,516.22,108.58,21.03366781604742,407.64,78.96633218395257,72900.95999999996,8.873800000000045,27.099040000000045
82,10,516.22,109.19,21.151834489171282,407.03,78.84816551082871,72791.76999999996,9.010287500000047,27.208230000000043
83,11,516.22,109.8,21.270001162295145,406.42,78.72999883770485,72681.96999999996,9.147537500000055,27.318030000000036
84,12,516.22,110.41,21.388167835419004,405.81,78.61183216458099,72571.55999999995,9.285550000000057,27.428440000000037
85,1,516.22,111.03,21.50827166711867,405.19,78.49172833288132,72460.52999999996,9.424337500000064,27.539470000000037
86,2,516.22,111.65,21.628375498818333,404.57,78.37162450118166,72348.87999999996,9.563900000000046,27.651120000000034
87,3,516.22,112.27,21.748479330517995,403.95,78.251520669482,72236.60999999996,9.704237500000062,27.763390000000044
88,4,516.22,112.9,21.87052032079346,403.32,78.12947967920654,72123.70999999996,9.84536250000005,27.87629000000004
89,5,516.22,113.53,21.992561311068922,402.69,78.00743868893107,72010.17999999996,9.98727500000004,27.989820000000037
90,6,516.22,114.16,22.114602301344384,402.06,77.88539769865561,71896.01999999996,10.129975000000044,28.103980000000035
91,7,516.22,114.8,22.238580450195652,401.42,77.76141954980434,71781.21999999996,10.273475000000047,28.218780000000038
92,8,516.22,115.44,22.362558599046917,400.78,77.63744140095308,71665.77999999996,10.417775000000049,28.334220000000045
93,9,516.22,116.09,22.48847390647398,400.13,77.511526093526,71549.68999999996,10.562887500000045,28.450310000000044
94,10,516.22,116.73,22.61245205532525,399.49,77.38754794467475,71432.95999999996,10.708800000000053,28.567040000000034
95,11,516.22,117.39,22.740304521328113,398.83,77.25969547867187,71315.56999999996,10.85553750000004,28.684430000000035
96,12,516.22,118.04,22.86621982875518,398.18,77.13378017124481,71197.52999999997,11.003087500000035,28.802470000000042
97,1,516.22,118.7,22.99407229475805,397.52,77.00592770524194,71078.82999999997,11.151462500000036,28.921170000000032
98,2,516.22,119.36,23.121924760760916,396.86,76.87807523923908,70959.46999999997,11.30066250000003,29.040530000000032
99,3,516.22,120.03,23.251714385339582,396.19,76.74828561466042,70839.43999999997,11.45070000000004,29.160560000000018
100,4,516.22,120.7,23.381504009918253,395.52,76.61849599008174,70718.73999999998,11.601575000000025,29.281260000000017
101,5,516.22,121.37,23.51129363449692,394.85,76.48870636550308,70597.36999999998,11.753287500000027,29.402630000000016
102,6,516.22,122.05,23.643020417651385,394.17,76.3569795823486,70475.31999999998,11.90585000000003,29.524680000000032
103,7,516.22,122.73,23.774747200805855,393.49,76.22525279919414,70352.58999999998,12.059262500000017,29.647410000000022
104,8,516.22,123.42,23.908411142536128,392.8,76.09158885746386,70229.16999999998,12.213537500000015,29.770830000000018
105,9,516.22,124.11,24.042075084266397,392.11,75.9579249157336,70105.05999999998,12.368675000000025,29.89494000000002
106,10,516.22,124.8,24.175739025996666,391.42,75.82426097400334,69980.25999999998,12.52467500000003,30.019740000000013
107,11,516.22,125.5,24.31134012630274,390.72,75.68865987369726,69854.75999999998,12.681550000000016,30.145240000000015
108,12,516.22,126.2,24.44694122660881,390.02,75.55305877339119,69728.55999999998,12.839300000000023,30.271440000000013
109,1,516.22,126.9,24.58254232691488,389.32,75.41745767308511,69601.65999999999,12.99792500000001,30.39834000000002
110,2,516.22,127.61,24.72008058579675,388.61,75.27991941420325,69474.04999999999,13.157437500000015,30.52595000000001
111,3,516.22,128.32,24.857618844678623,387.9,75.14238115532137,69345.72999999998,13.317837500000024,30.65427000000001
112,4,516.22,129.04,24.997094262136297,387.18,75.0029057378637,69216.68999999999,13.479137500000022,30.783310000000014
113,5,516.22,129.76,25.13656967959397,386.46,74.86343032040602,69086.93,13.641337500000006,30.913070000000005
114,6,516.22,130.48,25.276045097051643,385.74,74.72395490294835,68956.45,13.804437500000006,31.043549999999996
115,7,516.22,131.21,25.41745767308512,385.01,74.58254232691488,68825.23999999999,13.968450000000004,31.174760000000006
116,8,516.22,131.95,25.56080740769439,384.27,74.4391925923056,68693.29,14.133387500000012,31.30671000000001
117,9,516.22,132.68,25.70221998372787,383.54,74.29778001627213,68560.61,14.29923749999999,31.439390000000003
118,10,516.22,133.42,25.845569718337142,382.8,74.15443028166285,68427.19,14.46601249999999,31.57280999999999
119,11,516.22,134.17,25.99085661152222,382.05,74.00914338847778,68293.02,14.633724999999998,31.70698
120,12,516.22,134.92,26.13614350470729,381.3,73.86385649529271,68158.1,14.802374999999984,31.841899999999995
121,1,516.22,135.67,26.28143039789237,380.55,73.71856960210764,68022.43000000001,14.97196249999999,31.977569999999986
122,2,516.22,136.43,26.428654449653248,379.79,73.57134555034676,67886.00000000001,15.142499999999984,32.11399999999999
123,3,516.22,137.19,26.575878501414124,379.03,73.42412149858588,67748.81000000001,15.313987499999982,32.25118999999998
124,4,516.22,137.96,26.725039711750803,378.26,73.27496028824919,67610.85,15.486437499999994,32.38914999999999
125,5,516.22,138.73,26.874200922087475,377.49,73.12579907791252,67472.12000000001,15.659849999999992,32.52787999999998
126,6,516.22,139.5,27.02336213242416,376.72,72.97663786757585,67332.62000000001,15.83422499999999,32.667379999999994
127,7,516.22,140.28,27.17446050133664,375.94,72.82553949866336,67192.34000000001,16.009574999999984,32.80766
128,8,516.22,141.06,27.325558870249118,375.16,72.67444112975087,67051.28000000001,16.18589999999999,32.94871999999998
129,9,516.22,141.85,27.478594397737393,374.37,72.5214056022626,66909.43000000001,16.36321249999999,33.09057
130,10,516.22,142.64,27.631629925225674,373.58,72.36837007477432,66766.79000000001,16.541512499999982,33.233209999999985
131,11,516.22,143.44,27.78660261128976,372.78,72.21339738871023,66623.35,16.720812499999994,33.37665
132,12,516.22,144.24,27.941575297353843,371.98,72.05842470264616,66479.11,16.90111250000001,33.52089000000001
133,1,516.22,145.04,28.09654798341792,371.18,71.90345201658207,66334.07,17.08241249999999,33.66592999999999
134,2,516.22,145.85,28.253457828057805,370.37,71.7465421719422,66188.22,17.264725,33.81178
135,3,516.22,146.67,28.41230483127348,369.55,71.58769516872651,66041.55,17.448062499999992,33.95845
136,4,516.22,147.49,28.57115183448917,368.73,71.42884816551083,65894.06,17.632425000000012,34.105940000000004
137,5,516.22,148.31,28.72999883770485,367.91,71.27000116229515,65745.75,17.817812500000002,34.25425
138,6,516.22,149.14,28.890782999496334,367.08,71.10921700050366,65596.61,18.004237500000002,34.40339
139,7,516.22,149.97,29.05156716128782,366.25,70.94843283871216,65446.64,18.191699999999997,34.55336
140,8,516.22,150.81,29.21428848165511,365.41,70.7857115183449,65295.83,18.3802125,34.704170000000005
141,9,516.22,151.65,29.377009802022393,364.57,70.6229901979776,65144.18,18.569774999999993,34.85582000000001
142,10,516.22,152.5,29.541668280965478,363.72,70.45833171903452,64991.68,18.760400000000004,35.00832
143,11,516.22,153.35,29.706326759908563,362.87,70.29367324009144,64838.33,18.952087500000005,35.16167
144,12,516.22,154.21,29.872922397427455,362.01,70.12707760257254,64684.12,19.144850000000005,35.31587999999999
145,1,516.22,155.07,30.03951803494634,361.15,69.96048196505366,64529.05,19.338687499999992,35.47095
146,2,516.22,155.93,30.20611367246523,360.29,69.79388632753476,64373.12,19.533599999999993,35.62688
147,3,516.22,156.8,30.374646468559916,359.42,69.62535353144008,64216.32,19.729600000000005,35.78367999999999
148,4,516.22,157.68,30.545116423230407,358.54,69.4548835767696,64058.64,19.926699999999997,35.94136
149,5,516.22,158.56,30.715586377900895,357.66,69.28441362209911,63900.08,20.124899999999997,36.09992
150,6,516.22,159.44,30.886056332571382,356.78,69.11394366742861,63740.64,20.324200000000005,36.259359999999994
151,7,516.22,160.33,31.058463445817676,355.89,68.94153655418232,63580.31,20.524612500000003,36.41969
152,8,516.22,161.23,31.23280771763976,354.99,68.76719228236024,63419.079999999994,20.726150000000004,36.580920000000006
153,9,516.22,162.13,31.407151989461855,354.09,68.59284801053813,63256.95,20.928812500000006,36.74305
154,10,516.22,163.04,31.583433419859748,353.18,68.41656658014024,63093.909999999996,21.132612500000008,36.906090000000006
155,11,516.22,163.95,31.759714850257637,352.27,68.24028514974235,62929.96,21.337550000000007,37.070040000000006
156,12,516.22,164.86,31.935996280655537,351.36,68.06400371934447,62765.1,21.543625000000006,37.2349
157,1,516.22,165.78,32.11421486962923,350.44,67.88578513037076,62599.32,21.75085,37.400679999999994
158,2,516.22,166.71,32.29437061717873,349.51,67.70562938282127,62432.61,21.9592375,37.56739
159,3,516.22,167.64,32.47452636472821,348.58,67.52547363527178,62264.97,22.168787499999993,37.73503
160,4,516.22,168.57,32.654682112277705,347.65,67.34531788772227,62096.4,22.379499999999993,37.903600000000004
161,5,516.22,169.52,32.83871217697881,346.7,67.16128782302118,61926.880000000005,22.591399999999993,38.073119999999996
162,6,516.22,170.46,33.02080508310411,345.76,66.97919491689589,61756.420000000006,22.804474999999996,38.24358
163,7,516.22,171.41,33.2048351478052,344.81,66.7951648521948,61585.01,23.0187375,38.414989999999996
164,8,516.22,172.37,33.390802371082096,343.85,66.60919762891791,61412.64,23.2342,38.587360000000004
165,9,516.22,173.33,33.57676959435899,342.89,66.423230405641,61239.31,23.4508625,38.76069
166,10,516.22,174.3,33.7646739762117,341.92,66.2353260237883,61065.009999999995,23.668737500000006,38.93499
167,11,516.22,175.27,33.952578358064386,340.95,66.0474216419356,60889.74,23.887825000000007,39.11026
168,12,516.22,176.25,34.14241989849289,339.97,65.85758010150711,60713.49,24.108137499999998,39.28651
169,1,516.22,177.24,34.33419859749719,338.98,65.66580140250281,60536.25,24.32968749999999,39.46375
170,2,516.22,178.23,34.52597729650149,337.99,65.4740227034985,60358.02,24.552475,39.64198
171,3,516.22,179.22,34.71775599550579,337.0,65.2822440044942,60178.799999999996,24.7765,39.821200000000005
172,4,516.22,180.22,34.91147185308589,336.0,65.0885281469141,59998.579999999994,25.00177500000001,40.00142000000001
173,5,516.22,181.23,35.10712486924179,334.99,64.8928751307582,59817.34999999999,25.228312500000015,40.18265000000001
174,6,516.22,182.24,35.302777885397695,333.98,64.6972221146023,59635.10999999999,25.456112500000003,40.36489000000001
175,7,516.22,183.26,35.500368060129404,332.96,64.4996319398706,59451.84999999999,25.685187500000012,40.54815000000001
176,8,516.22,184.28,35.697958234861105,331.94,64.3020417651389,59267.56999999999,25.915537500000013,40.73243000000001
177,9,516.22,185.31,35.897485568168605,330.91,64.1025144318314,59082.259999999995,26.147175000000004,40.91774
178,10,516.22,186.34,36.09701290147611,329.88,63.90298709852388,58895.92,26.380100000000013,41.104079999999996
179,11,516.22,187.38,36.29847739335942,328.84,63.70152260664057,58708.54,26.614324999999994,41.29146
180,12,516.22,188.43,36.501879043818526,327.79,63.49812095618147,58520.11,26.8498625,41.47989
181,1,516.22,189.48,36.70528069427763,326.74,63.29471930572237,58330.63,27.086712500000004,41.66937000000001
182,2,516.22,190.54,36.91061950331254,325.68,63.089380496687454,58140.09,27.324887500000003,41.85991
183,3,516.22,191.6,37.115958312347445,324.62,62.88404168765255,57948.49,27.564387499999995,42.05151
184,4,516.22,192.67,37.32323427995815,323.55,62.676765720041836,57755.82,27.805225000000007,42.24418
185,5,516.22,193.75,37.53244740614466,322.47,62.46755259385534,57562.07,28.047412500000007,42.43793
186,6,516.22,194.83,37.74166053233118,321.39,62.25833946766882,57367.24,28.29095000000001,42.632760000000005
187,7,516.22,195.92,37.952810817093486,320.3,62.047189182906514,57171.32,28.535849999999996,42.82868
188,8,516.22,197.01,38.16396110185579,319.21,61.836038898144196,56974.31,28.782112499999997,43.025690000000004
189,9,516.22,198.11,38.37704854519391,318.11,61.622951454806085,56776.2,29.029749999999993,43.223800000000004
190,10,516.22,199.22,38.59207314710782,317.0,61.40792685289217,56576.979999999996,29.278774999999996,43.42302
191,11,516.22,200.33,38.807097749021736,315.89,61.19290225097826,56376.649999999994,29.529187500000006,43.62335
192,12,516.22,201.45,39.024059509511446,314.77,60.97594049048855,56175.2,29.781000000000006,43.82480000000001
193,1,516.22,202.58,39.24295842857696,313.64,60.75704157142303,55972.619999999995,30.034225000000006,44.02738000000001
194,2,516.22,203.71,39.46185734764248,312.51,60.53814265235752,55768.909999999996,30.288862500000008,44.23109000000001
195,3,516.22,204.84,39.68075626670799,311.38,60.319243733292005,55564.07,30.544912499999995,44.43593
196,4,516.22,205.99,39.90352950292511,310.23,60.0964704970749,55358.08,30.80239999999999,44.64192
197,5,516.22,207.14,40.126302739142226,309.08,59.873697260857774,55150.94,31.061324999999997,44.849059999999994
198,6,516.22,208.29,40.34907597535934,307.93,59.65092402464065,54942.65,31.321687499999996,45.05735
199,7,516.22,209.46,40.57572352872806,306.76,59.42427647127193,54733.19,31.583512499999998,45.26681
200,8,516.22,210.63,40.802371082096776,305.59,59.19762891790321,54522.560000000005,31.8468,45.477439999999994
201,9,516.22,211.8,41.0290186354655,304.42,58.9709813645345,54310.76,32.111549999999994,45.68924
202,10,516.22,212.98,41.25760334741002,303.24,58.74239665258998,54097.78,32.377775,45.90222000000001
203,11,516.22,214.17,41.48812521793033,302.05,58.51187478206966,53883.61,32.6454875,46.116389999999996
204,12,516.22,215.37,41.72058424702646,300.85,58.27941575297354,53668.24,32.91470000000001,46.33176
205,1,516.22,216.57,41.95304327612258,299.65,58.04695672387741,53451.67,33.1854125,46.54833000000001
206,2,516.22,217.78,42.187439463794504,298.44,57.812560536205496,53233.89,33.457637500000004,46.766110000000005
207,3,516.22,219.0,42.42377281004222,297.22,57.57622718995778,53014.89,33.7313875,46.98511
208,4,516.22,220.22,42.66010615628995,296.0,57.339893843710044,52794.67,34.006662500000004,47.205330000000004
209,5,516.22,221.45,42.898376661113474,294.77,57.10162333888652,52573.22,34.283474999999996,47.42678
210,6,516.22,222.69,43.1385843245128,293.53,56.861415675487194,52350.53,34.56183750000001,47.64947000000001
211,7,516.22,223.93,43.37879198791213,292.29,56.62120801208788,52126.6,34.841750000000005,47.8734
212,8,516.22,225.18,43.620936809887255,291.04,56.379063190112745,51901.42,35.123225000000005,48.09858
213,9,516.22,226.44,43.865018790438185,289.78,56.13498120956181,51674.979999999996,35.40627500000001,48.32502000000001
214,10,516.22,227.7,44.10910077098911,288.52,55.890899229010884,51447.28,35.6909,48.55272000000001
215,11,516.22,228.97,44.35511991011584,287.25,55.644880089884154,51218.31,35.977112500000004,48.78169
216,12,516.22,230.25,44.60307620781837,285.97,55.39692379218163,50988.06,36.264925000000005,49.011939999999996
217,1,516.22,231.54,44.8529696640967,284.68,55.14703033590329,50756.52,36.55435,49.243480000000005
218,2,516.22,232.83,45.102863120375034,283.39,54.897136879624966,50523.689999999995,36.8453875,49.47631
219,3,516.22,234.13,45.35469373522916,282.09,54.645306264770824,50289.56,37.13805,49.71044
220,4,516.22,235.44,45.6084615086591,280.78,54.391538491340896,50054.119999999995,37.43235,49.94588000000001
221,5,516.22,236.75,45.86222928208903,279.47,54.13777071791097,49817.369999999995,37.7282875,50.18263
222,6,516.22,238.07,46.11793421409477,278.15,53.88206578590523,49579.299999999996,38.025875000000006,50.420700000000004
223,7,516.22,239.4,46.375576304676294,276.82,53.6244236953237,49339.899999999994,38.32512500000001,50.66010000000001
224,8,516.22,240.74,46.635155553833634,275.48,53.36484444616636,49099.159999999996,38.62605,50.90084
225,9,516.22,242.08,46.894734802990975,274.14,53.10526519700902,48857.079999999994,38.92865000000001,51.142920000000004
226,10,516.22,243.43,47.15625121072411,272.79,52.84374878927589,48613.649999999994,39.232937500000006,51.38635000000001
227,11,516.22,244.79,47.41970477703305,271.43,52.58029522296695,48368.85999999999,39.53892500000001,51.63114000000001
228,12,516.22,246.16,47.685095501917786,270.06,52.314904498082214,48122.69999999999,39.84662500000001,51.87730000000001
229,1,516.22,247.53,47.950486226802525,268.69,52.049513773197475,47875.16999999999,40.15603750000001,52.12483000000001
230,2,516.22,248.92,48.21975126883886,267.3,51.78024873116113,47626.24999999999,40.467187500000016,52.37375000000001
231,3,516.22,250.31,48.48901631087521,265.91,51.51098368912479,47375.939999999995,40.780075000000004,52.62406000000001
232,4,516.22,251.7,48.758281352911546,264.52,51.24171864708844,47124.24,41.0947,52.87576
233,5,516.22,253.11,49.0314207120995,263.11,50.9685792879005,46871.13,41.4110875,53.12887
234,6,516.22,254.52,49.30456007128743,261.7,50.69543992871256,46616.61,41.729237499999996,53.38339
235,7,516.22,255.94,49.57963658905118,260.28,50.42036341094881,46360.67,42.0491625,53.63933
236,8,516.22,257.37,49.856650265390726,258.85,50.143349734609274,46103.299999999996,42.370875000000005,53.8967
237,9,516.22,258.81,50.13560110030607,257.41,49.86439889969393,45844.49,42.6943875,54.15551
238,10,516.22,260.25,50.41455193522142,255.97,49.58544806477858,45584.24,43.01970000000001,54.41576
239,11,516.22,261.71,50.69737708728835,254.51,49.30262291271163,45322.53,43.3468375,54.67747
240,12,516.22,263.17,50.98020223935531,253.05,49.019797760644686,45059.36,43.675799999999995,54.94064
241,1,516.22,264.64,51.26496454999806,251.58,48.73503545000194,44794.72,44.0066,55.20528
242,2,516.22,266.12,51.55166401921662,250.1,48.44833598078338,44528.6,44.33925,55.4714
243,3,516.22,267.6,51.83836348843517,248.62,48.161636511564836,44261.0,44.67375,55.739
244,4,516.22,269.1,52.128937274805324,247.12,47.87106272519468,43991.9,45.010125,56.0081
245,5,516.22,270.6,52.41951106117547,245.62,47.58048893882453,43721.3,45.348375,56.2787
246,6,516.22,272.11,52.712022006121416,244.11,47.28797799387858,43449.19,45.6885125,56.55081
247,7,516.22,273.63,53.00647010964317,242.59,46.993529890356825,43175.560000000005,46.03054999999999,56.824439999999996
248,8,516.22,275.16,53.30285537174073,241.06,46.69714462825927,42900.4,46.3745,57.0996
249,9,516.22,276.69,53.599240633838285,239.53,46.40075936616171,42623.71,46.7203625,57.376290000000004
250,10,516.22,278.24,53.899500213087435,237.98,46.10049978691255,42345.47,47.0681625,57.65453
251,11,516.22,279.79,54.1997597923366,236.43,45.8002402076634,42065.68,47.4179,57.93432
252,12,516.22,281.35,54.501956530161564,234.87,45.49804346983844,41784.33,47.7695875,58.215669999999996
253,1,516.22,282.92,54.806090426562314,233.3,45.19390957343768,41501.41,48.123237499999995,58.49858999999999
254,2,516.22,284.5,55.11216148153888,231.72,44.88783851846112,41216.91,48.4788625,58.78309
255,3,516.22,286.09,55.42016969509124,230.13,44.57983030490876,40930.82000000001,48.83647499999999,59.069179999999996
256,4,516.22,287.69,55.7301150672194,228.53,44.2698849327806,40643.130000000005,49.1960875,59.356869999999994
257,5,516.22,289.3,56.04199759792336,226.92,43.95800240207663,40353.83,49.557712499999994,59.64617
258,6,516.22,290.91,56.35388012862733,225.31,43.64611987137267,40062.92,49.92135,59.93708
259,7,516.22,292.54,56.6696369764829,223.68,43.3303630235171,39770.38,50.287025,60.22962
260,8,516.22,294.17,56.98539382433846,222.05,43.01460617566154,39476.21,50.6547375,60.52379
261,9,516.22,295.81,57.303087830769826,220.41,42.696912169230174,39180.4,51.0245,60.819599999999994
262,10,516.22,297.46,57.62271899577699,218.76,42.377281004223,38882.94,51.396325,61.117059999999995
263,11,516.22,299.12,57.944287319359965,217.1,42.055712680640035,38583.82,51.770225,61.41618
264,12,516.22,300.79,58.26779280151874,215.43,41.73220719848127,38283.03,52.1462125,61.716969999999996
265,1,516.22,302.47,58.5932354422533,213.75,41.4067645577467,37980.56,52.524300000000004,62.01944
266,2,516.22,304.16,58.92061524156368,212.06,41.07938475843632,37676.399999999994,52.90450000000001,62.323600000000006
267,3,516.22,305.86,59.24993219944985,210.36,40.750067800550156,37370.53999999999,53.28682500000001,62.62946000000001
268,4,516.22,307.57,59.581186315911815,208.65,40.41881368408818,37062.969999999994,53.671287500000005,62.93703000000001
269,5,516.22,309.29,59.9143775909496,206.93,40.0856224090504,36753.67999999999,54.05790000000001,63.246320000000004
270,6,516.22,311.01,60.24756886598737,205.21,39.752431134012625,36442.66999999999,54.44666250000001,63.55733000000001
271,7,516.22,312.75,60.584634458176744,203.47,39.41536554182325,36129.91999999999,54.83760000000001,63.87008000000001
272,8,516.22,314.49,60.92170005036613,201.73,39.07829994963387,35815.42999999999,55.23071250000001,64.18457000000001
273,9,516.22,316.25,61.2626399597071,199.97,38.7373600402929,35499.17999999999,55.626025000000006,64.50082
274,10,516.22,318.02,61.60551702762388,198.2,38.39448297237612,35181.159999999996,56.02355000000001,64.81884000000001
275,11,516.22,319.79,61.94839409554066,196.43,38.05160590445934,34861.369999999995,56.42328750000001,65.13863
276,12,516.22,321.58,62.29514548060904,194.64,37.70485451939095,34539.78999999999,56.82526250000001,65.46021000000002
277,1,516.22,323.37,62.641896865677424,192.85,37.358103134322576,34216.41999999999,57.229475000000015,65.78358
278,2,516.22,325.18,62.9925225678974,191.04,37.00747743210259,33891.23999999999,57.635950000000015,66.10876000000002
279,3,516.22,326.99,63.34314827011739,189.23,36.656851729882604,33564.24999999999,58.04468750000001,66.43575000000001
280,4,516.22,328.82,63.697648289488974,187.4,36.30235171051102,33235.42999999999,58.455712500000004,66.76457
281,5,516.22,330.66,64.05408546743637,185.56,35.945914532563634,32904.76999999999,58.86903750000002,67.09523000000002
282,6,516.22,332.5,64.41052264538375,183.72,35.58947735461624,32572.26999999999,59.28466250000001,67.42773000000001
283,7,516.22,334.36,64.77083414048273,181.86,35.22916585951726,32237.90999999999,59.702612500000015,67.76209000000001
284,8,516.22,336.23,65.13308279415753,179.99,34.86691720584247,31901.67999999999,60.122900000000016,68.09832000000002
285,9,516.22,338.1,65.49533144783231,178.12,34.50466855216768,31563.57999999999,60.54552500000001,68.43642000000001
286,10,516.22,339.99,65.86145441865871,176.23,34.13854558134128,31223.58999999999,60.97051250000001,68.77641000000001
287,11,516.22,341.89,66.22951454806089,174.33,33.770485451939095,30881.69999999999,61.39787500000001,69.1183
288,12,516.22,343.8,66.5995118360389,172.42,33.40048816396109,30537.89999999999,61.82762500000001,69.4621
289,1,516.22,345.72,66.9714462825927,170.5,33.028553717407306,30192.17999999999,62.25977500000001,69.80782
290,2,516.22,347.65,67.34531788772227,168.57,32.654682112277705,29844.529999999988,62.69433750000001,70.15547000000001
291,3,516.22,349.59,67.72112665142768,166.63,32.27887334857231,29494.939999999988,63.13132500000002,70.50506000000001
292,4,516.22,351.54,68.09887257370887,164.68,31.901127426291115,29143.399999999987,63.57075000000002,70.85660000000001
293,5,516.22,353.5,68.47855565456588,162.72,31.521444345434112,28789.899999999987,64.01262500000001,71.21010000000001
294,6,516.22,355.48,68.86211305257449,160.74,31.137886947425514,28434.419999999987,64.45697500000001,71.56558000000001
295,7,516.22,357.46,69.24567045058308,158.76,30.754329549416916,28076.95999999999,64.90380000000002,71.92304000000001
296,8,516.22,359.46,69.63310216574328,156.76,30.366897834256708,27717.49999999999,65.353125,72.28250000000001
297,9,516.22,361.46,70.02053388090349,154.76,29.979466119096504,27356.03999999999,65.80495000000002,72.64396
298,10,516.22,363.48,70.41183991321529,152.74,29.588160086784704,26992.55999999999,66.25930000000001,73.00744000000002
299,11,516.22,365.51,70.80508310410289,150.71,29.194916895897098,26627.049999999992,66.71618750000002,73.37295
300,12,516.22,367.55,71.20026345356631,148.67,28.799736546433685,26259.499999999993,67.17562500000001,73.74050000000001
301,1,516.22,369.6,71.59738096160552,146.62,28.402619038394484,25889.899999999994,67.63762500000001,74.1101
302,2,516.22,371.67,71.99837278679632,144.55,28.001627213203673,25518.229999999996,68.10221250000001,74.48177000000001
303,3,516.22,373.74,72.39936461198714,142.48,27.60063538801286,25144.489999999994,68.5693875,74.85551000000001
304,4,516.22,375.83,72.80423075432955,140.39,27.195769245670448,24768.659999999993,69.039175,75.23134
305,5,516.22,377.93,73.21103405524777,138.29,26.788965944752235,24390.729999999992,69.51158750000002,75.60927000000001
306,6,516.22,380.04,73.61977451474178,136.18,26.380225485258222,24010.68999999999,69.98663750000001,75.98931000000002
307,7,516.22,382.16,74.0304521328116,134.06,25.969547867188407,23628.52999999999,70.46433750000001,76.37147000000002
308,8,516.22,384.29,74.44306690945722,131.93,25.556933090542795,23244.23999999999,70.94470000000001,76.75576000000001
309,9,516.22,386.44,74.85955600325443,129.78,25.14044399674557,22857.799999999992,71.42775,77.1422
310,10,516.22,388.6,75.27798225562745,127.62,24.722017744372554,22469.199999999993,71.9135,77.5308
311,11,516.22,390.77,75.69834566657626,125.45,24.301654333423734,22078.429999999993,72.40196250000001,77.92157
312,12,516.22,392.95,76.12064623610088,123.27,23.87935376389911,21685.479999999992,72.89315000000002,78.31452
313,1,516.22,395.14,76.5448839642013,121.08,23.45511603579869,21290.339999999993,73.38707500000001,78.70966000000001
314,2,516.22,397.35,76.97299600945333,118.87,23.027003990546664,20892.989999999994,73.8837625,79.10701
315,3,516.22,399.57,77.40304521328115,116.65,22.59695478671884,20493.419999999995,74.38322500000001,79.50658
316,4,516.22,401.8,77.83503157568478,114.42,22.164968424315212,20091.619999999995,74.88547500000001,79.90838000000001
317,5,516.22,404.04,78.26895509666421,112.18,21.731044903335786,19687.579999999994,75.39052500000001,80.31242
318,6,516.22,406.3,78.70675293479525,109.92,21.293247065204756,19281.279999999995,75.89840000000001,80.71872
319,7,516.22,408.57,79.14648793150207,107.65,20.853512068497928,18872.709999999995,76.4091125,81.12729
320,8,516.22,410.85,79.58816008678471,105.37,20.411839913215296,18461.859999999997,76.922675,81.53814
321,9,516.22,413.14,80.03176940064313,103.08,19.96823059935686,18048.719999999998,77.4391,81.95128
322,10,516.22,415.45,80.47925303165316,100.77,19.520746968346828,17633.269999999997,77.95841250000001,82.36673
323,11,516.22,417.77,80.92867382123899,98.45,19.07132617876099,17215.499999999996,78.480625,82.78450000000001
324,12,516.22,420.1,81.38003176940065,96.12,18.61996823059936,16795.399999999998,79.00575,83.2046
325,1,516.22,422.45,81.83526403471387,93.77,18.164735965286116,16372.949999999997,79.53381250000001,83.62705
326,2,516.22,424.8,82.29049630002712,91.42,17.709503699972878,15948.149999999998,80.0648125,84.05185
327,3,516.22,427.18,82.75154004106776,89.04,17.248459958932237,15520.969999999998,80.5987875,84.47903
328,4,516.22,429.56,83.2125837821084,86.66,16.787416217891597,15091.409999999998,81.1357375,84.90859
329,5,516.22,431.96,83.67750184030064,84.26,16.322498159699354,14659.449999999999,81.67568750000001,85.34055000000001
330,6,516.22,434.37,84.14435705706869,81.85,15.855642942931306,14225.079999999998,82.21865,85.77492000000001
331,7,516.22,436.8,84.61508659098833,79.42,15.384913409011661,13788.279999999999,82.76465,86.21172
332,8,516.22,439.24,85.08775328348378,76.98,14.912246716516215,13349.039999999999,83.3137,86.65096
333,9,516.22,441.69,85.56235713455503,74.53,14.437642865444964,12907.349999999999,83.8658125,87.09265
334,10,516.22,444.15,86.03889814420208,72.07,13.961101855797914,12463.199999999999,84.421,87.5368
335,11,516.22,446.63,86.51931347100074,69.59,13.480686528999264,12016.57,84.9792875,87.98343
336,12,516.22,449.13,87.00360311495099,67.09,12.99639688504901,11567.44,85.5407,88.43256
337,1,516.22,451.64,87.48982991747704,64.58,12.510170082522954,11115.800000000001,86.10525,88.88419999999999
338,2,516.22,454.16,87.9779938785789,62.06,12.0220061214211,10661.640000000001,86.67295,89.33836
339,3,516.22,456.69,88.46809499825655,59.53,11.531905001743443,10204.95,87.2438125,89.79505
340,4,516.22,459.24,88.96207043508582,56.98,11.037929564914183,9745.710000000001,87.8178625,90.25429
341,5,516.22,461.81,89.45992018906668,54.41,10.540079810933321,9283.900000000001,88.395125,90.7161
342,6,516.22,464.38,89.95776994304752,51.84,10.042230056952462,8819.520000000002,88.9756,91.18048
343,7,516.22,466.98,90.4614311727558,49.24,9.538568827244198,8352.540000000003,89.559325,91.64746
344,8,516.22,469.58,90.96509240246405,46.64,9.034907597535934,7882.960000000003,90.1463,92.11704
345,9,516.22,472.21,91.47456510789972,44.01,8.525434892100266,7410.750000000003,90.73656249999999,92.58924999999999
346,10,516.22,474.84,91.98403781333539,41.38,8.0159621866646,6935.910000000003,91.3301125,93.06409
347,11,516.22,477.49,92.49738483592267,38.73,7.502615164077331,6458.420000000003,91.926975,93.54158
348,12,516.22,480.16,93.01460617566154,36.06,6.985393824338461,5978.260000000003,92.527175,94.02174
349,1,516.22,482.84,93.53376467397621,33.38,6.466235326023788,5495.420000000003,93.130725,94.50458
350,2,516.22,485.54,94.05679748944249,30.68,5.943202510557514,5009.880000000003,93.73765,94.99011999999999
351,3,516.22,488.25,94.58176746348455,27.97,5.418232536515439,4521.630000000003,94.3479625,95.47837
352,4,516.22,490.97,95.10867459610243,25.25,4.891325403897563,4030.6600000000026,94.961675,95.96934
353,5,516.22,493.72,95.64139320444771,22.5,4.358606795552284,3536.9400000000023,95.578825,96.46306
354,6,516.22,496.47,96.174111812793,19.75,3.825888187207004,3040.470000000002,96.1994125,96.95953
355,7,516.22,499.24,96.71070473828988,16.98,3.2892952617101234,2541.2300000000023,96.82346249999999,97.45877
356,8,516.22,502.03,97.25117198093834,14.19,2.7488280190616403,2039.2000000000023,97.451,97.96079999999999
357,9,516.22,504.83,97.79357638216264,11.39,2.206423617837356,1534.3700000000024,98.0820375,98.46563
358,10,516.22,507.65,98.33985510053851,8.57,1.6601448994614698,1026.7200000000025,98.7166,98.97328
359,11,516.22,510.49,98.89000813606602,5.73,1.1099918639339816,516.2300000000025,99.35471249999999,99.48376999999999
360,12,516.22,513.34,99.4420983301693,2.88,0.5579016698306922,2.8900000000024875,99.9963875,99.99710999999999
361,1,516.22,516.2,99.9961256828484,0.02,0.00387431715160203,-513.3099999999976,100.6416375,100.51331
